QxConst=qx.Const
QxClient=qx.sys.Client

QxDefaultSettings=qx.core.DefaultSettings
QxSettings=qx.core.Settings
QxMain=qx.core.Main
QxObject=qx.core.Object
QxTarget=qx.core.Target
QxApplication=qx.core.Init

QxRangeManager=qx.type.Range
QxSelectionStorage=qx.type.Selection
QxFlashPlayerVersion=qx.type.Version

QxTimer=qx.client.Timer
QxNativeWindow=qx.client.NativeWindow
QxClientWindow=qx.client.ClientWindow
QxCommand=qx.client.Command
QxBuilder=qx.client.Builder

QxDebug=qx.dev.Debug
QxTimeTracker=qx.dev.TimeTracker
QxDom=qx.dom
QxDomStyle=qx.dom.DomStyle

QxDataEvent=qx.event.type.DataEvent
QxDomEvent=qx.event.type.DomEvent
QxDragEvent=qx.event.type.DragEvent
QxEvent=qx.event.type.Event
QxFocusEvent=qx.event.type.FocusEvent
QxKeyEvent=qx.event.type.KeyEvent
QxMouseEvent=qx.event.type.MouseEvent

QxDragAndDropManager=qx.event.handler.DragAndDropHandler
QxEventManager=qx.event.handler.EventHandler
QxFocusManager=qx.event.handler.FocusHandler

QxRequest=qx.io.remote.RemoteRequest
QxRequestQueue=qx.io.remote.RemoteRequestQueue
QxResponse=qx.io.remote.RemoteResponse
QxCommonTransport=qx.io.remote.AbstractRemoteTransport
QxIframeTransport=qx.io.remote.IframeTransport
QxXmlhttpTransport=qx.io.remote.XmlhttpTransport

QxCookie=qx.io.local.CookieApi
QxCookieStorage=qx.io.local.CookieTransport

QxImagePreloader=qx.io.image.ImagePreloader
QxImagePreloaderSystem=qx.io.image.ImagePreloaderSystem

QxParent=qx.ui.core.Parent
QxWidget=qx.ui.core.Widget
QxClientDocument=qx.ui.core.ClientDocument
QxBlocker=qx.ui.core.Blocker

QxAtom=qx.ui.basic.Atom
QxImage=qx.ui.basic.Image
QxLabel=qx.ui.basic.Label
QxTerminator=qx.ui.basic.Terminator
QxInline=qx.ui.basic.Inline
QxHorizontalSpacer=qx.ui.basic.HorizontalSpacer
QxVerticalSpacer=qx.ui.basic.VerticalSpacer

QxBoxLayout=qx.ui.layout.BoxLayout
QxCanvasLayout=qx.ui.layout.CanvasLayout
QxDockLayout=qx.ui.layout.DockLayout
QxFlowLayout=qx.ui.layout.FlowLayout
QxHorizontalBoxLayout=qx.ui.layout.HorizontalBoxLayout
QxVerticalBoxLayout=qx.ui.layout.VerticalBoxLayout
QxGridLayout=qx.ui.layout.GridLayout

QxTextField=qx.ui.form.TextField
QxTextArea=qx.ui.form.TextArea
QxPasswordField=qx.ui.form.PasswordField
QxSpinner=qx.ui.form.Spinner
QxButton=qx.ui.form.Button
QxRepeatButton=qx.ui.form.RepeatButton
QxComboBox=qx.ui.form.ComboBox
QxList=qx.ui.form.List
QxCheckBox=qx.ui.form.CheckBox
QxRadioButton=qx.ui.form.RadioButton
QxListItem=qx.ui.form.ListItem
QxInputCheckIcon=qx.ui.form.InputCheckSymbol

QxFieldSet=qx.ui.fieldset.FieldSet
QxCheckBoxFieldSet=qx.ui.fieldset.CheckBoxFieldSet
QxRadioButtonFieldSet=qx.ui.fieldset.RadioButtonFieldSet

QxListView=qx.ui.listview.ListView
QxListViewContentCellHtml=qx.ui.listview.ListViewContentCellHtml
QxListViewContentCellIconHtml=qx.ui.listview.ListViewContentCellIconHtml
QxListViewContentCellImage=qx.ui.listview.ListViewContentCellImage
QxListViewContentCellLink=qx.ui.listview.ListViewContentCellLink
QxListViewContentCellText=qx.ui.listview.ListViewContentCellText
QxListViewHeader=qx.ui.listview.ListViewHeader
QxListViewHeaderCell=qx.ui.listview.ListViewHeaderCell
QxListViewHeaderSeparator=qx.ui.listview.ListViewHeaderSeparator
QxListViewPane=qx.ui.listview.ListViewPane

QxWindow=qx.ui.window.Window

QxPopup=qx.ui.popup.Popup
QxPopupAtom=qx.ui.popup.PopupAtom
QxToolTip=qx.ui.popup.ToolTip

QxMenu=qx.ui.menu.Menu
QxMenuBar=qx.ui.menu.MenuBar
QxMenuBarButton=qx.ui.menu.MenuBarButton
QxMenuButton=qx.ui.menu.MenuButton
QxMenuCheckBox=qx.ui.menu.MenuCheckBox
QxMenuLayout=qx.ui.menu.MenuLayout
QxMenuRadioButton=qx.ui.menu.MenuRadioButton
QxMenuSeparator=qx.ui.menu.MenuSeparator

QxCommonView=qx.ui.pageview.AbstractPageView
QxCommonViewBar=qx.ui.pageview.AbstractPageViewBar
QxCommonViewButton=qx.ui.pageview.AbstractPageViewButton
QxCommonViewPage=qx.ui.pageview.AbstractPageViewPage
QxCommonViewPane=qx.ui.pageview.AbstractPageViewPane

QxTabView=qx.ui.pageview.tabview.TabView
QxTabViewBar=qx.ui.pageview.tabview.TabViewBar
QxTabViewButton=qx.ui.pageview.tabview.TabViewButton
QxTabViewPage=qx.ui.pageview.tabview.TabViewPage
QxTabViewPane=qx.ui.pageview.tabview.TabViewPane

QxBarView=qx.ui.pageview.buttonview.ButtonView
QxBarViewBar=qx.ui.pageview.buttonview.ButtonViewBar
QxBarViewButton=qx.ui.pageview.buttonview.ButtonViewButton
QxBarViewPage=qx.ui.pageview.buttonview.ButtonViewPage
QxBarViewPane=qx.ui.pageview.buttonview.ButtonViewPane

QxToolBar=qx.ui.toolbar.ToolBar
QxToolBarButton=qx.ui.toolbar.ToolBarButton
QxToolBarCheckBox=qx.ui.toolbar.ToolBarCheckBox
QxToolBarMenuButton=qx.ui.toolbar.ToolBarMenuButton
QxToolBarPart=qx.ui.toolbar.ToolBarPart
QxToolBarPartHandle=qx.ui.toolbar.ToolBarPartHandle
QxToolBarRadioButton=qx.ui.toolbar.ToolBarRadioButton
QxToolBarSeparator=qx.ui.toolbar.ToolBarSeparator

QxTree=qx.ui.tree.Tree
QxTreeElement=qx.ui.tree.TreeElement
QxTreeFile=qx.ui.tree.TreeFile
QxTreeFolder=qx.ui.tree.TreeFolder

QxColorSelector=qx.ui.component.ColorSelector

QxCanvasLayoutImpl=qx.renderer.layout.CanvasLayoutImpl
QxDockLayoutImpl=qx.renderer.layout.DockLayoutImpl
QxFlowLayoutImpl=qx.renderer.layout.FlowLayoutImpl
QxGridLayoutImpl=qx.renderer.layout.GridLayoutImpl
QxHorizontalBoxLayoutImpl=qx.renderer.layout.HorizontalBoxLayoutImpl
QxLayoutImpl=qx.renderer.layout.LayoutImpl
QxMenuButtonLayoutImpl=qx.renderer.layout.MenuButtonLayoutImpl
QxMenuLayoutImpl=qx.renderer.layout.MenuLayoutImpl
QxVerticalBoxLayoutImpl=qx.renderer.layout.VerticalBoxLayoutImpl

QxBorder=qx.renderer.border.Border
QxBorderCache=qx.renderer.border.BorderCache
QxBorderObject=qx.renderer.border.BorderObject
QxBorderObjectPresets=qx.renderer.border.BorderObjectPresets
QxBorderPresets=qx.renderer.border.BorderPresets

QxColor=qx.renderer.color.Color
QxColorCache=qx.renderer.color.ColorCache
QxColorObject=qx.renderer.color.ColorObject

QxFont=qx.renderer.font.Font
QxFontCache=qx.renderer.font.FontCache
QxFontObject=qx.renderer.font.FontObject

QxAppearanceTheme=qx.renderer.theme.AppearanceTheme
QxColorTheme=qx.renderer.theme.ColorTheme
QxIconTheme=qx.renderer.theme.IconTheme
QxWidgetTheme=qx.renderer.theme.WidgetTheme

QxManager=qx.manager.object.ObjectManager
QxAppearanceManager=qx.manager.object.AppearanceManager
QxColorManager=qx.manager.object.ColorManager
QxPopupManager=qx.manager.object.PopupManager
QxMenuManager=qx.manager.object.MenuManager
QxToolTipManager=qx.manager.object.ToolTipManager
QxWindowManager=qx.manager.object.WindowManager
QxImageManager=qx.manager.object.ImageManager
QxImagePreloaderManager=qx.manager.object.ImagePreloaderManager

QxSelectionManager=qx.manager.selection.SelectionManager
QxDomSelectionManager=qx.manager.selection.DomSelectionManager
QxTreeSelectionManager=qx.manager.selection.TreeSelectionManager
QxVirtualSelectionManager=qx.manager.selection.VirtualSelectionManager
QxRadioManager=qx.manager.selection.RadioManager

QxFlash=qx.ui.embed.Flash
QxIframe=qx.ui.embed.Iframe
QxGallery=qx.ui.embed.Gallery
QxGalleryList=qx.ui.embed.GalleryList
QxHtml=qx.ui.embed.HtmlEmbed
QxIconHtml=qx.ui.embed.IconHtmlEmbed
QxLink=qx.ui.embed.LinkEmbed
QxText=qx.ui.embed.TextEmbed
QxNode=qx.ui.embed.NodeEmbed

QxTextile=qx.util.string.Textile

QxCompare=qx.util.compare
